NO assets/textures/wall.xpm
F 220,100,1
SO assets/img/"bar rel.xpm42"
EA ./hola/aa.xmp
WE ./hola/"a a".xmp
C 250,    30     ,1

       111111111
       100000001
111111 10000N001
100001 101100001
111111 111 11111

111
101
111