NO assets/textures/wall.xpm
F 220,100,1
SO assets/img/"bar rel.xpm42"
EA ./hola/aa.xmp
WE ./hola/"a a".xmp
C 250,    30     ,1

       111111111
    11100000001
1111110000N00111
10000000000011
1000111000001
10001 1000001
1000111000001
10011100000011
111  11111111

111
101
111