NO assets/textures/wall.xpm

SO assets/img/"bar rel.xpm42"
EA akjshdksajdh12312
WE ./hola/"a a".xmp



C 250,    30     ,1

F 2, 1, 1

      111111111
    11100000001
111111000000111
 11 110000000000011        1
 10110111000001           11
10001 1000001           11111
1000111000001
10011100000011
111  11111111N1		
1111111111111111
1111111111111111
