	 NO										./textures/water_1.png 
F 251, 208, 177

WE ./textures/water_5.png

SO ./textures/water_1.png	



EA ./textures/water_2.png
													C	 173, 235, 255

111111111111
1000001000001
11111111111111111111
10000000000011111111
11111111000000000001
10N00000000001111111
1000000000001 1111
1000010100001 1111
1000100010001
1000010100001
1000000000001
1111111111111
