
       NO         assets/textures/wall.xpm
SO assets/img/"bar rel.xpm42"
EA ./hola/aa.xmp
WE ./hola/"a a".xmp
C 250,30,0
F 250,30,0
1111
1101111111111
1101111111111
1010111111111
1000111111111
1000111111111
1000111111111
1000111111111
1000111111111
1000111111111
1000111111111
1000001000001
1000000000001
10N00000000001
1000000000001    1111
1000010100001    1111
1000100010001
1000010100001
1000000000001
1111111111111
