       NO         assets/textures/wall.xpm


F 220,100,1

SO assets/img/"bar rel.xpm42"
EA ./hola/aa.xmp
WE ./hola/"a a".xmp

C 250,30,0

1111 111
10N1 001
1111 111