NO assets/textures/wall.xpm
F 220,100,1
SO assets/img/"bar rel.xpm42"
EA ./hola/aa.xmp
WE ./hola/"a a".xmp
C 	250,    30     ,1


        111111111
        100000001
11111111100000001
100001111100N0001
111111	111111011
111111	111111111
111
101
111
