NO assets/textures/wall.xpm


F 220,100,1

SO assets/img/"bar rel.xpm42"
EA ./hola/aa.xmp
WE ./hola/"a a".xmp
C 	250,    30   , 1

111111111111
101001
1N1001
1010001
101  101
11 111