NO ./textures/water_1.png 
F 240, 255, 0 
SO ./textures/water_5.png
EA ./textures/water_2.png
WE ./textures/TILE_2C.PNG
C 47, 84, 143 

1111111111111
1001111111111
1010111111111
1000111111111
1000111111111
1000111111111
1100111111111
  1000111111111
  1000111111111
1100111111111
1111111111111
1111111111111
1000001000001
1000000000001
1000000000001
1000000000001
1000010100001
1000100010001111
1100000000001101
100010001000101
10N001010000011
10000000000001
1111111111111
100001010000011
10000000000001
1111111111111
