NO ./textures/my_sea.png 
F 240, 189, 113 
SO ./textures/cute_water2.png
EA ./textures/last_chance.png
WE ./textures/TILE_2C.PNG
C 47, 84, 143 

1111111111111
1001111111111
1010111111111
1000111111111
1000111111111
1000111111111
1000111111111
1000111111111
1000111111111
1000111111111
1111111111111
1111111111111
1000001000001
1000000000001
1000000000001
1000000000001
1000010100001
1000100010001111
1100000000001101
10001000100E101
100001010000011
10000000000001
1111111111111
100001010000011
10000000000001
1111111111111
