NO ./textures/BRICK_1A.PNG 
F 160,160,180
SO ./textures/BRICK_3B.PNG
EA ./textures/BRICK_2B.PNG
WE ./textures/TILE_2C.PNG
C 204,255,255

1111111111111
1001111111111
1010111111111
1000111111111
1000111111111
1000111111111
1000111111111
1000111111111
1000111111111
1000111111111
1111111111111
1111111111111
1000001000001
1000000000001
1000000000001
1000000000001
1000010100001
1000100010001
1100000000001
1000100010001
1000010100001
10000000000N1
1111111111111
