     NO	 									./textures/water_1.png 
F 251, 208, 177

WE ./textures/water_5.png

SO ./textures/water_1.png   



EA ./textures/water_2.png
													C	 173, 235, 255






1111111111111
	1001111111111
1010111111111
1000111111111
1000111111111
1000111111111
1100111111111
1000111111111
100111111111
1100111111111
1111111111111
1111111111111
1000001000001
1000000000001
1000000000001
10010000000001
1000010100001
1000100010001111
1100000000001101
10001000100010111
10N001010000011
10000000000001
1111111111111
100001010000011
10000000000001
1111111111111
