NO ./textures/water_1.png 
F 240, 255, 0 
SO ./textures/water_5.png
EA ./textures/water_2.png
WE ./textures/TILE_2C.PNG
C 47, 84, 143 

1111111111111111111
10S000000001
100000000001
101000000001
100000000001
100000000001
100000000001
1111111111111111111
