NO assets/textures/wall.xpm
F 220,100,1
SO assets/img/"bar rel.xpm42"
EA ./hola/aa.xmp
WE ./hola/"a a".xmp
C 250,    30     ,1

1101111111111
1010111111111
1000111111111
1000111111111
1000111111111
1000111111111
1000111111111
1000111111111
1000111111111
1111111111111
1111111111111
1000001000001
1000000000001
1000000000001
1000000000001    1111
1000010100001    1111
1000100010001    1111
110000N000001    1001
1000100010001    1111
1000010100001
1000000000001
1111111111111
