
NO ./textures/BRICK_1A.png 
F 160,160,180
SO ./textures/SAND_1A.png
EA ./textures/Sand.png
WE ./textures/TILE_2C.png
C 204,255,255


        1111111111111111111111111
        10000000011100000S0000001
        1011000001110000000000001
        1001000000000000000000001
111111111011010000000000000000001
100000000011000000000000111111111
111101111011111011100010010001 
111101111111110111011111000111
110000001101010111000000100011
100000000000000011000000100011
100000000000000011011110000001
110000011101010111111111100111
111101111111010111111110000011
111111111111111111111111111111
111111111111111111111111111111
111111111111111111111111111111
111111111111111111111111111111
111111111111111111111111111111
111111111111111111111111111111
111111111111111111111111111111
111111111111111111111111111111
111111111111111111111111111111
111111111111111111111111111111
111111111111111111111111111111
111111111111111111111111111111
111111111111111111111111111111
111111111111111111111111111111
111111111111111111111111111111
111111111111111111111111111111
