       NO         assets/textures/wall.xpm


F 220    ,   100    ,1

C 250,30,0
SO assets/img/"bar rel.xpm42"
EA ./hola/aa.xmp
WE ./hola/"a a".xmp

1111
1001  1111
1111  1001
1001  1111
10N
1111