NO ./textures/my_sea.png
SO ./textures/my_sea.png  
WE ./textures/water_1.png
EA ./textures/water_1.png
F 240,103,0
C 225,30,0

        1111111111111111111111111
111111111111111111111111111111111
1111011111   10111000000100011111
111101111111110111010100100011111
11000000110101011100000010001
1000000000000000110000001S101
10000000000000001101010010001
10000011101010111110111100001
11110111 1110101 101111010001
11111111 1111111 111111111111
