NO ./textures/alga.png 
F 240, 255, 182 
SO ./textures/bob_esponja.png
EA ./textures/alga.png
WE   ./textures/peces.png
C 1, 1, 248

1111111111111111 
1000000000000001
1000000000000001
1000000100000001
1000001E10000001
100000000000001
1000000000000001
1000000000000001
1111111111111111
